-------------#######
---S----------------
--------P----#######
--------------------
-----M--W--T----S---
---#------------#---
-----------S--------
OOOOOOCO--XXXXXXXXXX
UOOODOOO--XXXXXXRXXX
OOOOODOO--XXXRXX@@@@
********--XRXXXX@@@@